###############
#   ##   ##   #
# 1 ## 2 ## 3 #
# 0 ## T ## E #
##S############
###############