####################
##################E#
#1   2#4   5##7   8#
#     #     ##     #
#    0#    3T#    6#
#####S##############
####################